"filename", "language", "HTML", "JavaScript", "CSS", "comment", "blank", "total"
"c:\Users\HP\OneDrive - HTL-Eisenstadt\Dokumente\programming stuff\bld_trainer\aboutme.html", "HTML", 95, 0, 0, 0, 7, 102
"c:\Users\HP\OneDrive - HTL-Eisenstadt\Dokumente\programming stuff\bld_trainer\bldcubes.html", "HTML", 118, 0, 0, 0, 10, 128
"c:\Users\HP\OneDrive - HTL-Eisenstadt\Dokumente\programming stuff\bld_trainer\corners.html", "HTML", 1126, 0, 0, 1, 23, 1150
"c:\Users\HP\OneDrive - HTL-Eisenstadt\Dokumente\programming stuff\bld_trainer\css\cubes.css", "CSS", 0, 0, 98, 0, 13, 111
"c:\Users\HP\OneDrive - HTL-Eisenstadt\Dokumente\programming stuff\bld_trainer\css\footer.css", "CSS", 0, 0, 75, 5, 15, 95
"c:\Users\HP\OneDrive - HTL-Eisenstadt\Dokumente\programming stuff\bld_trainer\css\global.css", "CSS", 0, 0, 118, 0, 10, 128
"c:\Users\HP\OneDrive - HTL-Eisenstadt\Dokumente\programming stuff\bld_trainer\css\help.css", "CSS", 0, 0, 60, 0, 6, 66
"c:\Users\HP\OneDrive - HTL-Eisenstadt\Dokumente\programming stuff\bld_trainer\css\login.css", "CSS", 0, 0, 84, 0, 12, 96
"c:\Users\HP\OneDrive - HTL-Eisenstadt\Dokumente\programming stuff\bld_trainer\css\main-footer.css", "CSS", 0, 0, 14, 0, 2, 16
"c:\Users\HP\OneDrive - HTL-Eisenstadt\Dokumente\programming stuff\bld_trainer\css\maingrid.css", "CSS", 0, 0, 86, 0, 10, 96
"c:\Users\HP\OneDrive - HTL-Eisenstadt\Dokumente\programming stuff\bld_trainer\css\presets.css", "CSS", 0, 0, 87, 0, 11, 98
"c:\Users\HP\OneDrive - HTL-Eisenstadt\Dokumente\programming stuff\bld_trainer\css\resources.css", "CSS", 0, 0, 33, 0, 5, 38
"c:\Users\HP\OneDrive - HTL-Eisenstadt\Dokumente\programming stuff\bld_trainer\css\sets.css", "CSS", 0, 0, 135, 0, 16, 151
"c:\Users\HP\OneDrive - HTL-Eisenstadt\Dokumente\programming stuff\bld_trainer\css\settings.css", "CSS", 0, 0, 303, 3, 43, 349
"c:\Users\HP\OneDrive - HTL-Eisenstadt\Dokumente\programming stuff\bld_trainer\css\support.css", "CSS", 0, 0, 57, 0, 5, 62
"c:\Users\HP\OneDrive - HTL-Eisenstadt\Dokumente\programming stuff\bld_trainer\css\terms.css", "CSS", 0, 0, 18, 0, 1, 19
"c:\Users\HP\OneDrive - HTL-Eisenstadt\Dokumente\programming stuff\bld_trainer\css\token.css", "CSS", 0, 0, 91, 0, 11, 102
"c:\Users\HP\OneDrive - HTL-Eisenstadt\Dokumente\programming stuff\bld_trainer\css\tops-main.css", "CSS", 0, 0, 90, 0, 14, 104
"c:\Users\HP\OneDrive - HTL-Eisenstadt\Dokumente\programming stuff\bld_trainer\css\tops-pt.css", "CSS", 0, 0, 233, 0, 35, 268
"c:\Users\HP\OneDrive - HTL-Eisenstadt\Dokumente\programming stuff\bld_trainer\css\tops-side.css", "CSS", 0, 0, 38, 0, 5, 43
"c:\Users\HP\OneDrive - HTL-Eisenstadt\Dokumente\programming stuff\bld_trainer\css\training.css", "CSS", 0, 0, 288, 3, 50, 341
"c:\Users\HP\OneDrive - HTL-Eisenstadt\Dokumente\programming stuff\bld_trainer\edges.html", "HTML", 1200, 0, 0, 2, 24, 1226
"c:\Users\HP\OneDrive - HTL-Eisenstadt\Dokumente\programming stuff\bld_trainer\flips.html", "HTML", 437, 0, 0, 1, 18, 456
"c:\Users\HP\OneDrive - HTL-Eisenstadt\Dokumente\programming stuff\bld_trainer\help.html", "HTML", 149, 0, 0, 0, 8, 157
"c:\Users\HP\OneDrive - HTL-Eisenstadt\Dokumente\programming stuff\bld_trainer\index.html", "HTML", 226, 0, 0, 0, 13, 239
"c:\Users\HP\OneDrive - HTL-Eisenstadt\Dokumente\programming stuff\bld_trainer\ltct.html", "HTML", 740, 0, 0, 1, 16, 757
"c:\Users\HP\OneDrive - HTL-Eisenstadt\Dokumente\programming stuff\bld_trainer\midges.html", "HTML", 939, 0, 0, 1, 16, 956
"c:\Users\HP\OneDrive - HTL-Eisenstadt\Dokumente\programming stuff\bld_trainer\parity.html", "HTML", 533, 0, 0, 2, 23, 558
"c:\Users\HP\OneDrive - HTL-Eisenstadt\Dokumente\programming stuff\bld_trainer\pluscenters.html", "HTML", 1070, 0, 0, 1, 19, 1090
"c:\Users\HP\OneDrive - HTL-Eisenstadt\Dokumente\programming stuff\bld_trainer\privacy.html", "HTML", 86, 0, 0, 0, 7, 93
"c:\Users\HP\OneDrive - HTL-Eisenstadt\Dokumente\programming stuff\bld_trainer\resources.html", "HTML", 141, 0, 0, 0, 8, 149
"c:\Users\HP\OneDrive - HTL-Eisenstadt\Dokumente\programming stuff\bld_trainer\script.js", "JavaScript", 0, 1737, 0, 153, 178, 2068
"c:\Users\HP\OneDrive - HTL-Eisenstadt\Dokumente\programming stuff\bld_trainer\terms.html", "HTML", 87, 0, 0, 0, 7, 94
"c:\Users\HP\OneDrive - HTL-Eisenstadt\Dokumente\programming stuff\bld_trainer\twists.html", "HTML", 388, 0, 0, 1, 18, 407
"c:\Users\HP\OneDrive - HTL-Eisenstadt\Dokumente\programming stuff\bld_trainer\wings.html", "HTML", 1016, 0, 0, 1, 16, 1033
"c:\Users\HP\OneDrive - HTL-Eisenstadt\Dokumente\programming stuff\bld_trainer\words.html", "HTML", 1069, 0, 0, 1, 16, 1086
"c:\Users\HP\OneDrive - HTL-Eisenstadt\Dokumente\programming stuff\bld_trainer\xcenters.html", "HTML", 1070, 0, 0, 1, 19, 1090
"Total", "-", 10490, 1737, 1908, 177, 710, 15022